11 11 11 11 11 11 12 21 21 21 21 21 21 21 21 21 21 21 14 11 11 11 11 11 11 11 11 11 11 11 11 0 0 0 0 0 0 0 0 0 0 0 0 0 0 0 0 0 0 0 
11 11 12 21 21 21 16 39 39 39 39 39 39 39 39 39 39 39 18 21 21 21 21 21 21 14 11 11 11 11 11 0 0 0 0 0 0 0 0 0 0 0 0 0 0 0 0 0 0 0 
11 12 16 39 39 39 39 39 39 39 39 39 39 39 39 39 39 39 39 39 39 39 39 39 39 18 14 11 11 11 11 0 0 0 0 0 0 0 0 0 0 0 0 0 0 0 0 0 0 0 
11 20 39 39 39 39 39 39 39 39 39 39 39 39 39 39 39 39 39 39 39 39 39 39 39 39 18 14 11 11 11 0 0 0 0 0 0 0 0 0 0 0 0 0 0 0 0 0 0 0 
12 16 39 39 39 39 39 39 39 42 51 44 39 39 39 39 39 39 39 37 39 39 39 39 39 39 39 18 14 11 11 0 0 0 0 0 0 0 0 0 0 0 0 0 0 0 0 0 0 0 
20 39 39 39 39 39 39 42 51 46 41 48 51 51 51 44 37 37 37 37 37 37 39 39 37 39 39 39 22 11 11 0 0 0 0 0 0 0 0 0 0 0 0 0 0 0 0 0 0 0 
20 39 39 39 39 42 51 46 41 41 41 41 41 41 41 52 37 37 37 37 37 37 37 39 39 39 39 39 22 11 11 0 0 0 0 0 0 0 0 0 0 0 0 0 0 0 0 0 0 0 
20 39 39 37 39 50 41 41 41 41 49 53 53 53 53 45 37 37 37 37 37 37 37 37 37 39 39 39 22 11 11 0 0 0 0 0 0 0 0 0 0 0 0 0 0 0 0 0 0 0 
20 39 39 37 40 43 53 53 53 53 45 37 37 37 37 37 37 37 37 37 37 37 37 37 37 39 39 39 22 11 11 0 0 0 0 0 0 0 0 0 0 0 0 0 0 0 0 0 0 0 
20 39 39 37 37 37 37 37 37 37 37 37 38 38 38 37 37 37 37 37 37 37 37 37 37 37 37 39 18 14 11 0 0 0 0 0 0 0 0 0 0 0 0 0 0 0 0 0 0 0 
20 39 37 37 37 37 37 37 37 37 38 37 37 38 37 38 37 38 37 38 37 38 37 37 37 37 37 39 39 22 11 0 0 0 0 0 0 0 0 0 0 0 0 0 0 0 0 0 0 0 
20 39 39 37 37 37 37 37 38 38 37 37 37 37 37 37 38 37 37 38 37 38 38 37 37 37 37 39 39 22 11 0 0 0 0 0 0 0 0 0 0 0 0 0 0 0 0 0 0 0 
20 39 39 37 37 37 37 38 37 37 39 39 39 39 39 39 39 39 39 37 37 37 38 38 37 37 37 39 39 22 11 0 0 0 0 0 0 0 0 0 0 0 0 0 0 0 0 0 0 0 
13 17 39 37 37 37 38 37 37 39 39 37 37 37 37 37 37 37 39 39 39 38 37 38 37 37 37 39 39 22 11 0 0 0 0 0 0 0 0 0 0 0 0 0 0 0 0 0 0 0 
11 20 39 37 37 38 37 37 37 39 37 42 51 51 44 37 37 37 37 37 39 39 37 37 38 37 37 37 39 22 11 0 0 0 0 0 0 0 0 0 0 0 0 0 0 0 0 0 0 0 
11 20 39 37 37 37 38 37 39 39 42 46 49 47 48 44 37 37 37 37 37 39 39 37 37 38 37 37 39 22 11 0 0 0 0 0 0 0 0 0 0 0 0 0 0 0 0 0 0 0 
11 20 39 40 37 37 38 37 39 42 46 49 45 43 47 48 44 37 37 37 37 37 39 37 37 38 37 37 39 22 11 0 0 0 0 0 0 0 0 0 0 0 0 0 0 0 0 0 0 0 
11 20 39 39 37 38 37 37 39 50 49 45 37 37 43 53 45 38 37 37 37 37 39 37 37 37 38 37 39 22 11 0 0 0 0 0 0 0 0 0 0 0 0 0 0 0 0 0 0 0 
11 20 39 39 37 38 37 37 39 50 48 44 37 37 38 38 38 37 38 37 38 37 37 38 38 38 38 37 39 22 11 0 0 0 0 0 0 0 0 0 0 0 0 0 0 0 0 0 0 0 
12 16 39 39 37 37 38 37 39 43 47 52 37 37 37 38 37 38 37 38 37 38 38 37 37 37 38 37 39 22 11 0 0 0 0 0 0 0 0 0 0 0 0 0 0 0 0 0 0 0 
20 39 39 39 37 37 37 37 39 39 50 48 51 51 51 51 44 38 37 37 37 37 39 39 37 37 38 38 39 22 11 0 0 0 0 0 0 0 0 0 0 0 0 0 0 0 0 0 0 0 
20 39 39 39 38 37 38 37 37 39 43 53 53 53 53 53 45 37 37 37 37 37 39 39 39 39 37 38 19 15 11 0 0 0 0 0 0 0 0 0 0 0 0 0 0 0 0 0 0 0 
13 17 39 39 37 37 37 37 37 39 39 39 37 37 37 37 37 37 37 37 37 39 39 37 37 39 38 38 9 11 11 0 0 0 0 0 0 0 0 0 0 0 0 0 0 0 0 0 0 0 
11 20 39 39 37 38 37 37 37 37 37 39 39 39 40 37 37 37 39 39 39 39 37 38 37 39 37 37 22 11 11 0 0 0 0 0 0 0 0 0 0 0 0 0 0 0 0 0 0 0 
11 20 39 39 37 37 37 37 37 37 37 37 37 39 39 39 39 39 37 37 37 37 37 37 37 39 37 37 22 11 11 0 0 0 0 0 0 0 0 0 0 0 0 0 0 0 0 0 0 0 
11 13 17 39 37 38 38 37 37 38 38 37 37 37 37 38 38 37 37 38 37 37 38 37 39 39 37 37 22 11 11 0 0 0 0 0 0 0 0 0 0 0 0 0 0 0 0 0 0 0 
11 11 20 39 37 37 37 38 38 37 37 37 37 38 38 37 37 37 37 37 37 37 39 39 39 37 37 37 22 11 11 0 0 0 0 0 0 0 0 0 0 0 0 0 0 0 0 0 0 0 
11 11 13 17 38 37 39 39 39 39 37 39 39 39 39 39 39 37 39 39 39 39 37 37 37 37 19 23 15 11 11 0 0 0 0 0 0 0 0 0 0 0 0 0 0 0 0 0 0 0 
11 11 11 13 6 23 23 17 39 39 39 39 39 39 39 39 39 19 23 23 23 23 23 23 23 23 15 11 11 11 11 0 0 0 0 0 0 0 0 0 0 0 0 0 0 0 0 0 0 0 
11 11 11 11 11 11 11 13 23 23 23 23 23 23 23 23 23 15 11 11 11 11 11 11 11 11 11 11 11 11 11 0 0 0 0 0 0 0 0 0 0 0 0 0 0 0 0 0 0 0 
11 11 11 11 11 11 11 11 11 11 11 11 11 11 11 11 11 11 11 11 11 11 11 11 11 11 11 11 11 11 11 0 0 0 0 0 0 0 0 0 0 0 0 0 0 0 0 0 0 0 
0 0 0 0 0 0 0 0 0 0 0 0 0 0 0 0 0 0 0 0 0 0 0 0 0 0 0 0 0 0 0 0 0 0 0 0 0 0 0 0 0 0 0 0 0 0 0 0 0 0 
0 0 0 0 0 0 0 0 0 0 0 0 0 0 0 0 0 0 0 0 0 0 0 0 0 0 0 0 0 0 0 0 0 0 0 0 0 0 0 0 0 0 0 0 0 0 0 0 0 0 
0 0 0 0 0 0 0 0 0 0 0 0 0 0 0 0 0 0 0 0 0 0 0 0 0 0 0 0 0 0 0 0 0 0 0 0 0 0 0 0 0 0 0 0 0 0 0 0 0 0 
0 0 0 0 0 0 0 0 0 0 0 0 0 0 0 0 0 0 0 0 0 0 0 0 0 0 0 0 0 0 0 0 0 0 0 0 0 0 0 0 0 0 0 0 0 0 0 0 0 0 
0 0 0 0 0 0 0 0 0 0 0 0 0 0 0 0 0 0 0 0 0 0 0 0 0 0 0 0 0 0 0 0 0 0 0 0 0 0 0 0 0 0 0 0 0 0 0 0 0 0 
0 0 0 0 0 0 0 0 0 0 0 0 0 0 0 0 0 0 0 0 0 0 0 0 0 0 0 0 0 0 0 0 0 0 0 0 0 0 0 0 0 0 0 0 0 0 0 0 0 0 
0 0 0 0 0 0 0 0 0 0 0 0 0 0 0 0 0 0 0 0 0 0 0 0 0 0 0 0 0 0 0 0 0 0 0 0 0 0 0 0 0 0 0 0 0 0 0 0 0 0 
0 0 0 0 0 0 0 0 0 0 0 0 0 0 0 0 0 0 0 0 0 0 0 0 0 0 0 0 0 0 0 0 0 0 0 0 0 0 0 0 0 0 0 0 0 0 0 0 0 0 
0 0 0 0 0 0 0 0 0 0 0 0 0 0 0 0 0 0 0 0 0 0 0 0 0 0 0 0 0 0 0 0 0 0 0 0 0 0 0 0 0 0 0 0 0 0 0 0 0 0 
0 0 0 0 0 0 0 0 0 0 0 0 0 0 0 0 0 0 0 0 0 0 0 0 0 0 0 0 0 0 0 0 0 0 0 0 0 0 0 0 0 0 0 0 0 0 0 0 0 0 
0 0 0 0 0 0 0 0 0 0 0 0 0 0 0 0 0 0 0 0 0 0 0 0 0 0 0 0 0 0 0 0 0 0 0 0 0 0 0 0 0 0 0 0 0 0 0 0 0 0 
0 0 0 0 0 0 0 0 0 0 0 0 0 0 0 0 0 0 0 0 0 0 0 0 0 0 0 0 0 0 0 0 0 0 0 0 0 0 0 0 0 0 0 0 0 0 0 0 0 0 
0 0 0 0 0 0 0 0 0 0 0 0 0 0 0 0 0 0 0 0 0 0 0 0 0 0 0 0 0 0 0 0 0 0 0 0 0 0 0 0 0 0 0 0 0 0 0 0 0 0 
0 0 0 0 0 0 0 0 0 0 0 0 0 0 0 0 0 0 0 0 0 0 0 0 0 0 0 0 0 0 0 0 0 0 0 0 0 0 0 0 0 0 0 0 0 0 0 0 0 0 
0 0 0 0 0 0 0 0 0 0 0 0 0 0 0 0 0 0 0 0 0 0 0 0 0 0 0 0 0 0 0 0 0 0 0 0 0 0 0 0 0 0 0 0 0 0 0 0 0 0 
0 0 0 0 0 0 0 0 0 0 0 0 0 0 0 0 0 0 0 0 0 0 0 0 0 0 0 0 0 0 0 0 0 0 0 0 0 0 0 0 0 0 0 0 0 0 0 0 0 0 
0 0 0 0 0 0 0 0 0 0 0 0 0 0 0 0 0 0 0 0 0 0 0 0 0 0 0 0 0 0 0 0 0 0 0 0 0 0 0 0 0 0 0 0 0 0 0 0 0 0 
0 0 0 0 0 0 0 0 0 0 0 0 0 0 0 0 0 0 0 0 0 0 0 0 0 0 0 0 0 0 0 0 0 0 0 0 0 0 0 0 0 0 0 0 0 0 0 0 0 0 
0 0 0 0 0 0 0 0 0 0 0 0 0 0 0 0 0 0 0 0 0 0 0 0 0 0 0 0 0 0 0 0 0 0 0 0 0 0 0 0 0 0 0 0 0 0 0 0 0 0 
