11 11 11 11 11 11 12 21 21 21 21 21 21 21 21 21 4 21 14 11 11 11 11 11 11 11 11 11 11 11 11 0 0 0 0 0 0 0 0 0 0 0 0 0 0 0 0 0 0 0 
11 11 12 21 21 21 16 37 37 37 37 37 37 37 37 37 38 37 18 21 21 21 21 21 21 14 11 11 11 11 11 0 0 0 0 0 0 0 0 0 0 0 0 0 0 0 0 0 0 0 
11 12 16 39 39 39 37 37 37 37 38 37 38 38 38 37 37 37 37 37 37 37 37 37 37 18 14 11 11 11 11 0 0 0 0 0 0 0 0 0 0 0 0 0 0 0 0 0 0 0 
11 20 39 39 39 37 37 37 38 38 37 38 38 37 38 37 38 37 37 37 37 37 37 37 37 37 18 14 11 11 11 0 0 0 0 0 0 0 0 0 0 0 0 0 0 0 0 0 0 0 
12 16 39 39 37 37 38 37 38 37 37 37 37 37 37 37 37 37 42 51 51 51 51 51 44 37 37 18 14 11 11 0 0 0 0 0 0 0 0 0 0 0 0 0 0 0 0 0 0 0 
20 39 39 37 38 38 37 38 37 42 51 51 51 51 51 51 51 51 46 41 41 41 41 41 52 37 37 37 22 11 11 0 0 0 0 0 0 0 0 0 0 0 0 0 0 0 0 0 0 0 
20 39 37 37 38 37 37 37 37 50 41 41 41 41 41 41 41 41 41 41 41 41 41 41 48 44 37 37 22 11 11 0 0 0 0 0 0 0 0 0 0 0 0 0 0 0 0 0 0 0 
20 39 37 37 38 37 39 37 37 50 41 41 41 41 41 41 41 41 41 41 41 41 41 41 41 52 37 37 22 11 11 0 0 0 0 0 0 0 0 0 0 0 0 0 0 0 0 0 0 0 
20 39 37 38 37 37 39 37 37 50 41 41 41 41 41 41 41 41 41 41 41 41 41 41 41 52 37 37 22 11 11 0 0 0 0 0 0 0 0 0 0 0 0 0 0 0 0 0 0 0 
20 39 37 37 38 37 39 37 37 50 41 41 41 41 41 41 41 41 41 41 41 41 41 41 41 52 37 37 18 14 11 0 0 0 0 0 0 0 0 0 0 0 0 0 0 0 0 0 0 0 
20 39 37 37 37 37 39 39 37 43 53 53 47 41 41 41 41 41 41 41 41 41 41 41 49 45 37 37 37 22 11 0 0 0 0 0 0 0 0 0 0 0 0 0 0 0 0 0 0 0 
20 39 39 37 37 38 39 39 37 37 37 37 50 41 41 41 41 41 41 41 41 41 41 41 52 37 37 37 39 22 11 0 0 0 0 0 0 0 0 0 0 0 0 0 0 0 0 0 0 0 
20 39 39 37 38 38 39 39 37 37 37 37 50 41 41 41 41 41 41 41 41 41 41 41 52 37 37 39 39 22 11 0 0 0 0 0 0 0 0 0 0 0 0 0 0 0 0 0 0 0 
13 17 39 37 38 37 39 39 37 37 37 37 43 53 53 47 41 41 41 41 41 49 53 53 45 37 37 39 39 22 11 0 0 0 0 0 0 0 0 0 0 0 0 0 0 0 0 0 0 0 
11 20 39 37 38 37 39 39 39 37 37 37 37 37 37 43 53 53 53 53 53 45 37 37 37 37 37 39 39 22 11 0 0 0 0 0 0 0 0 0 0 0 0 0 0 0 0 0 0 0 
11 20 39 37 37 37 39 39 39 39 37 37 37 37 37 37 37 37 37 37 37 37 37 37 37 37 39 39 39 22 11 0 0 0 0 0 0 0 0 0 0 0 0 0 0 0 0 0 0 0 
11 20 39 37 38 37 39 39 39 39 39 37 37 37 37 37 37 37 37 37 37 37 37 37 39 39 39 39 37 22 11 0 0 0 0 0 0 0 0 0 0 0 0 0 0 0 0 0 0 0 
11 20 39 37 37 37 37 39 39 39 39 39 37 37 37 37 37 37 37 37 37 37 37 39 39 39 37 37 37 22 11 0 0 0 0 0 0 0 0 0 0 0 0 0 0 0 0 0 0 0 
11 20 39 39 37 37 37 37 37 37 39 39 39 39 39 39 39 39 39 39 39 39 39 39 39 37 37 37 37 22 11 0 0 0 0 0 0 0 0 0 0 0 0 0 0 0 0 0 0 0 
12 16 39 37 37 38 37 37 37 37 39 39 39 39 39 39 39 39 39 39 39 39 39 39 37 37 37 37 37 22 11 0 0 0 0 0 0 0 0 0 0 0 0 0 0 0 0 0 0 0 
20 39 39 37 37 37 38 38 37 38 37 38 38 37 39 39 39 39 39 39 37 37 37 37 37 37 37 37 37 22 11 0 0 0 0 0 0 0 0 0 0 0 0 0 0 0 0 0 0 0 
20 39 39 37 37 37 37 37 38 37 37 37 38 38 37 38 37 37 37 37 37 37 37 37 37 37 37 37 19 15 11 0 0 0 0 0 0 0 0 0 0 0 0 0 0 0 0 0 0 0 
13 17 39 39 37 37 37 37 37 37 39 37 37 37 37 38 37 38 37 38 37 38 38 37 37 37 37 37 22 11 11 0 0 0 0 0 0 0 0 0 0 0 0 0 0 0 0 0 0 0 
11 20 39 39 39 39 39 39 39 39 39 39 39 39 39 39 39 39 39 37 37 37 38 37 37 37 37 37 22 11 11 0 0 0 0 0 0 0 0 0 0 0 0 0 0 0 0 0 0 0 
11 20 39 39 39 39 39 39 37 39 39 39 39 39 39 39 39 39 39 39 39 37 38 37 37 37 37 37 22 11 11 0 0 0 0 0 0 0 0 0 0 0 0 0 0 0 0 0 0 0 
11 13 17 39 39 37 38 37 37 37 37 38 38 37 37 37 37 37 37 37 37 38 37 37 37 37 37 37 22 11 11 0 0 0 0 0 0 0 0 0 0 0 0 0 0 0 0 0 0 0 
11 11 20 37 37 38 38 37 38 37 38 37 37 37 38 38 38 38 38 38 37 37 37 37 37 37 37 37 22 11 11 0 0 0 0 0 0 0 0 0 0 0 0 0 0 0 0 0 0 0 
11 11 13 17 38 37 37 37 37 37 37 38 37 37 37 37 37 37 37 37 37 37 37 37 37 37 19 23 15 11 11 0 0 0 0 0 0 0 0 0 0 0 0 0 0 0 0 0 0 0 
11 11 11 13 10 23 23 17 37 37 37 37 37 37 37 37 37 19 23 23 23 23 23 23 23 23 15 11 11 11 11 0 0 0 0 0 0 0 0 0 0 0 0 0 0 0 0 0 0 0 
11 11 11 11 11 11 11 13 23 23 23 23 23 23 23 23 23 15 11 11 11 11 11 11 11 11 11 11 11 11 11 0 0 0 0 0 0 0 0 0 0 0 0 0 0 0 0 0 0 0 
11 11 11 11 11 11 11 11 11 11 11 11 11 11 11 11 11 11 11 11 11 11 11 11 11 11 11 11 11 11 11 0 0 0 0 0 0 0 0 0 0 0 0 0 0 0 0 0 0 0 
0 0 0 0 0 0 0 0 0 0 0 0 0 0 0 0 0 0 0 0 0 0 0 0 0 0 0 0 0 0 0 0 0 0 0 0 0 0 0 0 0 0 0 0 0 0 0 0 0 0 
0 0 0 0 0 0 0 0 0 0 0 0 0 0 0 0 0 0 0 0 0 0 0 0 0 0 0 0 0 0 0 0 0 0 0 0 0 0 0 0 0 0 0 0 0 0 0 0 0 0 
0 0 0 0 0 0 0 0 0 0 0 0 0 0 0 0 0 0 0 0 0 0 0 0 0 0 0 0 0 0 0 0 0 0 0 0 0 0 0 0 0 0 0 0 0 0 0 0 0 0 
0 0 0 0 0 0 0 0 0 0 0 0 0 0 0 0 0 0 0 0 0 0 0 0 0 0 0 0 0 0 0 0 0 0 0 0 0 0 0 0 0 0 0 0 0 0 0 0 0 0 
0 0 0 0 0 0 0 0 0 0 0 0 0 0 0 0 0 0 0 0 0 0 0 0 0 0 0 0 0 0 0 0 0 0 0 0 0 0 0 0 0 0 0 0 0 0 0 0 0 0 
0 0 0 0 0 0 0 0 0 0 0 0 0 0 0 0 0 0 0 0 0 0 0 0 0 0 0 0 0 0 0 0 0 0 0 0 0 0 0 0 0 0 0 0 0 0 0 0 0 0 
0 0 0 0 0 0 0 0 0 0 0 0 0 0 0 0 0 0 0 0 0 0 0 0 0 0 0 0 0 0 0 0 0 0 0 0 0 0 0 0 0 0 0 0 0 0 0 0 0 0 
0 0 0 0 0 0 0 0 0 0 0 0 0 0 0 0 0 0 0 0 0 0 0 0 0 0 0 0 0 0 0 0 0 0 0 0 0 0 0 0 0 0 0 0 0 0 0 0 0 0 
0 0 0 0 0 0 0 0 0 0 0 0 0 0 0 0 0 0 0 0 0 0 0 0 0 0 0 0 0 0 0 0 0 0 0 0 0 0 0 0 0 0 0 0 0 0 0 0 0 0 
0 0 0 0 0 0 0 0 0 0 0 0 0 0 0 0 0 0 0 0 0 0 0 0 0 0 0 0 0 0 0 0 0 0 0 0 0 0 0 0 0 0 0 0 0 0 0 0 0 0 
0 0 0 0 0 0 0 0 0 0 0 0 0 0 0 0 0 0 0 0 0 0 0 0 0 0 0 0 0 0 0 0 0 0 0 0 0 0 0 0 0 0 0 0 0 0 0 0 0 0 
0 0 0 0 0 0 0 0 0 0 0 0 0 0 0 0 0 0 0 0 0 0 0 0 0 0 0 0 0 0 0 0 0 0 0 0 0 0 0 0 0 0 0 0 0 0 0 0 0 0 
0 0 0 0 0 0 0 0 0 0 0 0 0 0 0 0 0 0 0 0 0 0 0 0 0 0 0 0 0 0 0 0 0 0 0 0 0 0 0 0 0 0 0 0 0 0 0 0 0 0 
0 0 0 0 0 0 0 0 0 0 0 0 0 0 0 0 0 0 0 0 0 0 0 0 0 0 0 0 0 0 0 0 0 0 0 0 0 0 0 0 0 0 0 0 0 0 0 0 0 0 
0 0 0 0 0 0 0 0 0 0 0 0 0 0 0 0 0 0 0 0 0 0 0 0 0 0 0 0 0 0 0 0 0 0 0 0 0 0 0 0 0 0 0 0 0 0 0 0 0 0 
0 0 0 0 0 0 0 0 0 0 0 0 0 0 0 0 0 0 0 0 0 0 0 0 0 0 0 0 0 0 0 0 0 0 0 0 0 0 0 0 0 0 0 0 0 0 0 0 0 0 
0 0 0 0 0 0 0 0 0 0 0 0 0 0 0 0 0 0 0 0 0 0 0 0 0 0 0 0 0 0 0 0 0 0 0 0 0 0 0 0 0 0 0 0 0 0 0 0 0 0 
0 0 0 0 0 0 0 0 0 0 0 0 0 0 0 0 0 0 0 0 0 0 0 0 0 0 0 0 0 0 0 0 0 0 0 0 0 0 0 0 0 0 0 0 0 0 0 0 0 0 
0 0 0 0 0 0 0 0 0 0 0 0 0 0 0 0 0 0 0 0 0 0 0 0 0 0 0 0 0 0 0 0 0 0 0 0 0 0 0 0 0 0 0 0 0 0 0 0 0 0 
