11 11 11 11 11 11 12 21 21 21 21 21 21 21 21 21 21 21 14 11 11 11 11 11 11 11 11 11 11 11 11 0 0 0 0 0 0 0 0 0 0 0 0 0 0 0 0 0 0 0 
11 11 12 21 8 21 16 37 39 39 39 39 39 39 39 39 39 37 18 21 21 21 21 21 21 14 11 11 11 11 11 0 0 0 0 0 0 0 0 0 0 0 0 0 0 0 0 0 0 0 
11 12 16 37 37 37 37 37 37 37 37 39 39 37 39 39 39 39 39 39 39 39 39 39 39 18 14 11 11 11 11 0 0 0 0 0 0 0 0 0 0 0 0 0 0 0 0 0 0 0 
11 20 39 39 37 37 37 37 37 37 37 37 37 39 39 39 39 39 42 51 51 51 51 44 39 39 18 14 11 11 11 0 0 0 0 0 0 0 0 0 0 0 0 0 0 0 0 0 0 0 
12 16 39 37 37 37 37 37 37 37 37 39 39 39 39 39 39 42 46 41 41 41 41 52 39 39 39 18 14 11 11 0 0 0 0 0 0 0 0 0 0 0 0 0 0 0 0 0 0 0 
20 39 39 37 37 37 37 37 37 39 39 39 37 39 39 39 39 43 53 53 53 47 41 48 44 39 39 39 22 11 11 0 0 0 0 0 0 0 0 0 0 0 0 0 0 0 0 0 0 0 
20 39 37 37 37 37 37 37 37 39 39 37 39 39 39 39 37 37 37 37 37 43 53 53 45 37 39 39 22 11 11 0 0 0 0 0 0 0 0 0 0 0 0 0 0 0 0 0 0 0 
20 39 37 37 37 37 39 39 39 39 39 39 39 37 37 37 37 37 39 37 37 37 37 37 37 37 39 37 22 11 11 0 0 0 0 0 0 0 0 0 0 0 0 0 0 0 0 0 0 0 
20 39 37 37 37 37 37 37 37 37 37 37 37 37 37 37 37 37 39 37 37 37 37 37 37 37 39 39 22 11 11 0 0 0 0 0 0 0 0 0 0 0 0 0 0 0 0 0 0 0 
20 39 39 37 37 37 37 37 37 37 37 37 37 37 37 37 37 39 39 37 37 37 37 37 37 37 39 39 18 14 11 0 0 0 0 0 0 0 0 0 0 0 0 0 0 0 0 0 0 0 
20 39 39 37 37 37 37 37 37 37 37 37 37 37 37 37 37 39 39 37 37 37 37 37 37 37 37 39 39 22 11 0 0 0 0 0 0 0 0 0 0 0 0 0 0 0 0 0 0 0 
20 39 39 37 37 37 37 37 37 37 37 37 42 51 51 44 37 39 39 37 37 37 37 37 37 37 37 37 39 22 22 0 0 0 0 0 0 0 0 0 0 0 0 0 0 0 0 0 0 0 
20 37 39 39 37 37 37 37 42 51 51 51 46 41 41 52 39 39 39 37 37 37 37 37 37 37 37 37 39 22 11 0 0 0 0 0 0 0 0 0 0 0 0 0 0 0 0 0 0 0 
13 17 39 39 37 37 37 37 50 41 41 41 41 41 41 48 51 44 39 39 37 37 37 37 37 37 37 37 39 22 11 0 0 0 0 0 0 0 0 0 0 0 0 0 0 0 0 0 0 0 
11 20 39 39 37 37 37 37 43 53 53 53 47 41 41 41 41 48 44 39 37 37 37 37 37 37 37 37 39 22 11 0 0 0 0 0 0 0 0 0 0 0 0 0 0 0 0 0 0 0 
11 20 39 39 39 39 39 39 39 39 39 39 43 53 47 41 41 41 52 39 39 37 37 37 37 37 37 39 39 22 11 0 0 0 0 0 0 0 0 0 0 0 0 0 0 0 0 0 0 0 
11 20 39 39 39 39 39 39 39 39 39 39 39 39 43 47 41 41 52 39 39 37 37 37 37 37 37 39 39 22 11 0 0 0 0 0 0 0 0 0 0 0 0 0 0 0 0 0 0 0 
11 20 37 39 37 37 37 37 37 37 39 39 39 39 39 43 53 53 45 39 39 37 37 37 37 37 37 39 39 22 11 0 0 0 0 0 0 0 0 0 0 0 0 0 0 0 0 0 0 0 
11 20 37 37 37 37 37 37 37 37 37 37 37 37 39 39 39 39 39 39 39 37 37 37 37 37 37 39 39 22 11 0 0 0 0 0 0 0 0 0 0 0 0 0 0 0 0 0 0 0 
12 16 37 37 37 37 37 37 37 37 37 37 37 37 37 39 39 39 39 39 37 37 37 37 37 37 37 39 39 22 11 0 0 0 0 0 0 0 0 0 0 0 0 0 0 0 0 0 0 0 
20 37 37 37 37 37 37 39 37 37 37 37 37 37 37 37 37 37 37 37 37 37 37 37 37 37 37 39 39 22 11 0 0 0 0 0 0 0 0 0 0 0 0 0 0 0 0 0 0 0 
20 37 37 37 37 37 39 39 37 37 37 37 37 37 37 37 37 37 37 37 37 37 37 37 37 37 39 39 19 15 11 0 0 0 0 0 0 0 0 0 0 0 0 0 0 0 0 0 0 0 
13 17 37 37 37 37 37 39 39 39 39 39 37 37 37 37 37 37 37 37 37 37 37 37 37 37 39 39 22 11 11 0 0 0 0 0 0 0 0 0 0 0 0 0 0 0 0 0 0 0 
11 20 42 51 44 37 37 37 37 39 39 39 37 37 37 37 37 37 37 37 37 37 37 37 37 37 39 39 22 11 11 0 0 0 0 0 0 0 0 0 0 0 0 0 0 0 0 0 0 0 
11 20 43 47 48 44 37 37 37 37 39 39 39 39 37 37 37 37 37 37 37 37 37 37 37 37 37 39 22 11 11 0 0 0 0 0 0 0 0 0 0 0 0 0 0 0 0 0 0 0 
11 13 17 50 41 48 44 37 37 37 37 37 37 39 39 39 37 37 37 37 37 37 37 37 37 37 39 39 22 11 11 0 0 0 0 0 0 0 0 0 0 0 0 0 0 0 0 0 0 0 
11 11 20 43 47 41 48 51 51 44 37 37 37 37 37 39 39 39 39 39 39 39 39 39 39 39 39 39 22 11 11 0 0 0 0 0 0 0 0 0 0 0 0 0 0 0 0 0 0 0 
11 11 13 17 43 53 53 53 47 52 37 37 37 37 37 37 37 39 39 39 39 39 39 39 39 39 19 23 15 11 11 0 0 0 0 0 0 0 0 0 0 0 0 0 0 0 0 0 0 0 
11 11 11 13 23 23 23 17 43 45 37 37 37 37 37 37 37 19 23 23 23 23 23 23 23 23 15 11 11 11 11 0 0 0 0 0 0 0 0 0 0 0 0 0 0 0 0 0 0 0 
11 11 11 11 11 11 11 13 23 23 23 23 23 23 23 6 23 15 11 11 11 11 11 11 11 11 11 11 11 11 11 0 0 0 0 0 0 0 0 0 0 0 0 0 0 0 0 0 0 0 
11 11 11 11 11 11 11 11 11 11 11 11 11 11 11 11 11 11 11 11 11 11 11 11 11 11 11 11 11 11 11 0 0 0 0 0 0 0 0 0 0 0 0 0 0 0 0 0 0 0 
0 0 0 0 0 0 0 0 0 0 0 0 0 0 0 0 0 0 0 0 0 0 0 0 0 0 0 0 0 0 0 0 0 0 0 0 0 0 0 0 0 0 0 0 0 0 0 0 0 0 
0 0 0 0 0 0 0 0 0 0 0 0 0 0 0 0 0 0 0 0 0 0 0 0 0 0 0 0 0 0 0 0 0 0 0 0 0 0 0 0 0 0 0 0 0 0 0 0 0 0 
0 0 0 0 0 0 0 0 0 0 0 0 0 0 0 0 0 0 0 0 0 0 0 0 0 0 0 0 0 0 0 0 0 0 0 0 0 0 0 0 0 0 0 0 0 0 0 0 0 0 
0 0 0 0 0 0 0 0 0 0 0 0 0 0 0 0 0 0 0 0 0 0 0 0 0 0 0 0 0 0 0 0 0 0 0 0 0 0 0 0 0 0 0 0 0 0 0 0 0 0 
0 0 0 0 0 0 0 0 0 0 0 0 0 0 0 0 0 0 0 0 0 0 0 0 0 0 0 0 0 0 0 0 0 0 0 0 0 0 0 0 0 0 0 0 0 0 0 0 0 0 
0 0 0 0 0 0 0 0 0 0 0 0 0 0 0 0 0 0 0 0 0 0 0 0 0 0 0 0 0 0 0 0 0 0 0 0 0 0 0 0 0 0 0 0 0 0 0 0 0 0 
0 0 0 0 0 0 0 0 0 0 0 0 0 0 0 0 0 0 0 0 0 0 0 0 0 0 0 0 0 0 0 0 0 0 0 0 0 0 0 0 0 0 0 0 0 0 0 0 0 0 
0 0 0 0 0 0 0 0 0 0 0 0 0 0 0 0 0 0 0 0 0 0 0 0 0 0 0 0 0 0 0 0 0 0 0 0 0 0 0 0 0 0 0 0 0 0 0 0 0 0 
0 0 0 0 0 0 0 0 0 0 0 0 0 0 0 0 0 0 0 0 0 0 0 0 0 0 0 0 0 0 0 0 0 0 0 0 0 0 0 0 0 0 0 0 0 0 0 0 0 0 
0 0 0 0 0 0 0 0 0 0 0 0 0 0 0 0 0 0 0 0 0 0 0 0 0 0 0 0 0 0 0 0 0 0 0 0 0 0 0 0 0 0 0 0 0 0 0 0 0 0 
0 0 0 0 0 0 0 0 0 0 0 0 0 0 0 0 0 0 0 0 0 0 0 0 0 0 0 0 0 0 0 0 0 0 0 0 0 0 0 0 0 0 0 0 0 0 0 0 0 0 
0 0 0 0 0 0 0 0 0 0 0 0 0 0 0 0 0 0 0 0 0 0 0 0 0 0 0 0 0 0 0 0 0 0 0 0 0 0 0 0 0 0 0 0 0 0 0 0 0 0 
0 0 0 0 0 0 0 0 0 0 0 0 0 0 0 0 0 0 0 0 0 0 0 0 0 0 0 0 0 0 0 0 0 0 0 0 0 0 0 0 0 0 0 0 0 0 0 0 0 0 
0 0 0 0 0 0 0 0 0 0 0 0 0 0 0 0 0 0 0 0 0 0 0 0 0 0 0 0 0 0 0 0 0 0 0 0 0 0 0 0 0 0 0 0 0 0 0 0 0 0 
0 0 0 0 0 0 0 0 0 0 0 0 0 0 0 0 0 0 0 0 0 0 0 0 0 0 0 0 0 0 0 0 0 0 0 0 0 0 0 0 0 0 0 0 0 0 0 0 0 0 
0 0 0 0 0 0 0 0 0 0 0 0 0 0 0 0 0 0 0 0 0 0 0 0 0 0 0 0 0 0 0 0 0 0 0 0 0 0 0 0 0 0 0 0 0 0 0 0 0 0 
0 0 0 0 0 0 0 0 0 0 0 0 0 0 0 0 0 0 0 0 0 0 0 0 0 0 0 0 0 0 0 0 0 0 0 0 0 0 0 0 0 0 0 0 0 0 0 0 0 0 
0 0 0 0 0 0 0 0 0 0 0 0 0 0 0 0 0 0 0 0 0 0 0 0 0 0 0 0 0 0 0 0 0 0 0 0 0 0 0 0 0 0 0 0 0 0 0 0 0 0 
0 0 0 0 0 0 0 0 0 0 0 0 0 0 0 0 0 0 0 0 0 0 0 0 0 0 0 0 0 0 0 0 0 0 0 0 0 0 0 0 0 0 0 0 0 0 0 0 0 0 
